%%%%%%%%%%%%%%%%%%%%%%%%%%%%%%%
%.%........... G %  o%%%%.....%
%.%.%%%%%%%.%%%%%% %%%%%%%.%%.%
%............%...%............%
%%%%%...%%%..     ..%.%...%.%%%
%o%%%.%%%%%.%%%%%%%.%%%.%.%%%%%
%    ..........Po...%...%.   o%
%%%%%%%%%%%%%%%%%%%%%%%%%%%%%%%
